donne 	vouloir
veux 	vouloir
voudrais 	vouloir
cherche 	vouloir
affiche 	vouloir
afficher 	vouloir
souhaites 	vouloir
savoir 	vouloir
voir 	vouloir
quel 	vouloir
quels 	vouloir
quelle 	vouloir
quelles 	vouloir
trouve-moi 	vouloir
retournez 	vouloir
retourner 	vouloir
avoir 	vouloir
fichier 	article
fichiers 	article
page 	page
datant 	date
datent 	date
parus 	date
parlant 	mot
parle 	mot
parlent 	mot
parler 	mot
contenir 	mot
contient 	mot
contiennent 	mot
contenant 	mot
traitent 	mot
traite 	mot
traiter 	mot
traitant 	mot
concernent 	mot
concernant 	mot
Ã©voquant 	mot
sur 	mot
mots 	mot
combien 	nombre
contact 	auteur
contacts  	auteur